10******************
b------------------*
*------------------*
*------------------*
*------------------*
*------------------*
*------------------*
*------------------*
*------------------*
*********l*********a